x: 8
y: 8
s: 64
m: [
    1, 1, 1, 1, 1, 1 ,1 ,1,
    1, 0, 0, 0, 0, 0 ,0 ,1,
    1, 0, 0, 0, 1, 1 ,0 ,1,
    1, 0, 0, 0, 1, 1 ,0 ,1,
    1, 0, 1, 1, 1, 1 ,0 ,1,
    1, 0, 1, 0, 0, 1 ,0 ,1,
    1, 0, 1, 0, 0, 0 ,0 ,1,
    1, 1, 1, 1, 1, 1 ,1 ,1
    ]